111111111111111
100000000000001
1002010001P0001
10000E000100001
1000000201C0001
1000000201C0001
111111111111111